{
    "name": "map",
    "texture": "map_texture_64x64",
    "width": 20,
    "height": 13,
    "tileWidth": 64,
    "tileHeight": 64,
    "back": [
        24,1,1,1,1,1,1,1,1,1,1,1,1,1,1,1,1,1,1,23,
        1,4,5,5,5,5,5,5,5,5,5,5,5,5,5,5,5,5,6,1,
        1,20,3,3,3,3,3,3,3,3,3,3,3,3,3,3,3,3,7,1,
        1,20,3,3,3,3,3,3,3,3,3,3,3,3,3,3,3,3,7,1,
        1,20,3,3,3,3,3,3,3,3,3,3,3,3,3,3,3,3,7,1,
        22,20,3,3,3,3,3,3,3,3,3,3,3,3,3,3,3,3,7,1,
        1,20,3,3,3,3,3,3,3,3,3,3,3,3,3,3,3,3,7,1,
        1,20,3,3,3,3,3,3,3,3,3,3,3,3,3,3,3,3,7,1,
        1,20,3,3,3,3,3,3,3,3,3,3,3,3,3,3,3,3,7,21,
        1,19,3,3,3,3,3,3,3,3,3,3,3,3,3,3,3,3,8,1,
        17,18,13,13,14,15,13,13,13,13,15,14,13,13,13,13,12,11,9,10,
        1,1,1,1,1,1,1,1,1,1,1,1,1,1,1,1,1,1,1,1,
        1,1,1,1,1,1,1,1,1,1,1,1,1,1,1,1,1,1,1,1
    ],
    "front": [],
    "tiles": [
        {
            "value": 1,
            "collision": "0x1111"
        },
        {
            "value": 2,
            "collision": "0x1111"
        }
    ]
}