{
    "name": "map",
    "texture": "ice_map_64x64",
    "width": 20,
    "height": 13,
    "tileWidth": 64,
    "tileHeight": 64,
    "back": [
        19,19,19,19,19,19,19,19,19,19,19,19,19,19,19,19,19,19,19,23,
        19,4,5,5,5,5,5,5,5,5,5,5,5,5,5,5,5,5,6,19,
        19,3,1,1,1,1,1,1,1,1,1,1,1,1,1,1,1,1,7,19,
        22,3,1,1,1,1,1,1,1,1,1,1,1,1,1,1,1,1,7,19,
        19,3,1,1,1,1,1,1,1,1,1,1,1,1,1,1,1,1,7,23,
        19,3,1,1,1,1,1,1,1,1,1,1,1,1,1,1,1,1,7,19,
        24,3,1,1,1,1,1,1,1,1,1,1,1,1,1,1,1,1,7,19,
        19,3,1,1,1,1,1,1,1,1,1,1,1,1,1,1,1,1,7,21,
        19,3,1,1,1,1,1,1,1,1,1,1,1,1,1,1,1,1,7,19,
        19,2,1,1,1,1,1,1,1,1,1,1,1,1,1,1,1,1,8,19,
        17,16,12,12,13,10,14,14,13,12,12,10,15,14,12,12,11,10,9,18,
        19,19,19,19,19,19,19,19,19,19,19,19,19,19,19,19,19,19,19,19,
        19,19,19,19,19,19,19,19,19,19,19,19,19,19,19,19,19,19,19,19
    ],
    "front": [],
    "tiles": [
        {
            "value": 1,
            "collision": "0x1111"
        },
        {
            "value": 2,
            "collision": "0x1111"
        }
    ]
}