{
    "name": "map",
    "texture": "map_texture",
    "width": 20,
    "height": 13,
    "tileWidth": 64,
    "tileHeight": 64,
    "back": [
        1,1,1,1,1,1,1,1,1,1,1,1,1,1,1,1,1,1,1,1,
1,3,4,4,4,4,4,4,4,4,4,4,4,4,4,4,4,4,5,1,
1,7,2,2,2,2,2,2,2,2,2,2,2,2,2,2,2,2,6,1,
1,7,2,2,2,2,2,2,2,2,2,2,2,2,2,2,2,2,6,1,
1,7,2,2,2,2,2,2,2,2,2,2,2,2,2,2,2,2,6,1,
1,7,2,2,2,2,2,2,2,2,2,2,2,2,2,2,2,2,6,1,
1,7,2,2,2,2,2,2,2,2,2,2,2,2,2,2,2,2,6,1,
1,7,2,2,2,2,2,2,2,2,2,2,2,2,2,2,2,2,6,1,
1,7,2,2,2,2,2,2,2,2,2,2,2,2,2,2,2,2,6,1,
1,7,2,2,2,2,2,2,2,2,2,2,2,2,2,2,2,2,6,1,
1,9,17,17,17,17,17,17,17,17,17,17,17,17,17,17,17,17,8,1,
1,1,1,1,1,1,1,1,1,1,1,1,1,1,1,1,1,1,1,1,
1,1,1,1,1,1,1,1,1,1,1,1,1,1,1,1,1,1,1,1
    ],
    "front": [],
    "tiles": [
        {
            "value": 1,
            "collision": "0x1111"
        },
        {
            "value": 2,
            "collision": "0x1111"
        }
    ]
}