{
    "name": "map",
    "texture": "map_texture",
    "width": 20,
    "height": 13,
    "tileWidth": 64,
    "tileHeight": 64,
    "back": [
        30,1,1,1,18,1,1,31,30,1,1,18,1,1,1,31,1,30,1,1,
        1,3,4,4,4,4,4,4,4,4,4,4,4,4,4,4,4,4,5,1,
        31,7,2,2,2,2,2,2,2,2,2,2,2,2,2,2,2,2,6,1,
        1,7,2,2,2,2,2,2,2,2,2,2,2,2,2,2,2,2,6,31,
        1,7,2,2,2,2,2,2,2,2,2,2,2,2,2,2,2,2,6,30,
        29,7,2,2,2,2,2,2,2,2,2,2,2,2,2,2,2,2,6,1,
        1,7,2,2,2,2,2,2,2,2,2,2,2,2,2,2,2,2,6,28,
        1,7,2,2,2,2,2,2,2,2,2,2,2,2,2,2,2,2,6,1,
        30,7,2,2,2,2,2,2,2,2,2,2,2,2,2,2,2,2,6,18,
        1,7,2,2,2,2,2,2,2,2,2,2,2,2,2,2,2,2,6,1,
        10,9,14,16,13,17,17,15,16,12,16,16,17,17,15,13,17,16,8,11,
        1,1,1,1,1,1,1,1,1,1,1,1,1,1,1,1,1,1,1,1,
        1,1,1,1,1,1,1,1,1,1,1,1,1,1,1,1,1,1,1,1
    ],
    "front": [],
    "tiles": [
        {
            "value": 1,
            "collision": "0x1111"
        },
        {
            "value": 2,
            "collision": "0x1111"
        }
    ]
}