{
    "name": "map",
    "texture": "map_testcracks",
    "width": 20,
    "height": 13,
    "tileWidth": 64,
    "tileHeight": 64,
    "back": [
        1,1,1,1,1,1,1,1,1,1,1,1,1,1,1,1,1,1,1,1,
       1,2,2,2,2,2,2,2,2,2,2,2,2,2,2,2,2,2,2,1,
       1,2,2,2,2,2,2,2,2,2,2,2,2,2,2,2,2,2,2,1,
       1,2,2,2,2,2,2,2,2,2,2,2,2,2,2,2,2,2,2,1,
       1,2,2,2,2,2,2,2,2,2,2,2,2,2,2,2,2,2,2,1,
       1,2,2,2,2,2,2,2,2,2,2,2,2,2,2,2,2,2,2,1,
       1,2,2,2,2,2,2,2,2,2,2,2,2,2,2,2,2,2,2,1,
       1,2,2,2,2,2,2,2,2,2,2,2,2,2,2,2,2,2,2,1,
       1,2,2,2,2,2,2,2,2,2,2,2,2,2,2,2,2,2,2,1,
       1,2,2,2,2,2,2,2,2,2,2,2,2,2,2,2,2,2,2,1,
       1,2,2,2,2,2,2,2,2,2,2,2,2,2,2,2,2,2,2,1,
       1,1,1,1,1,1,1,1,1,1,1,1,1,1,1,1,1,1,1,1,
       1,1,1,1,1,1,1,1,1,1,1,1,1,1,1,1,1,1,1,1
    ],
    "front": [],
    "tiles": [
        {
            "value": 1,
            "collision": "0x1111"
        },
        {
            "value": 2,
            "collision": "0x1111"
        }
    ]
}